133
19
0 0 0 0 0 0 0 0	0 0 0 0	0 0 0 0	0 0 0 0	0 0 0 0	0 0 0 0	0 0 0 0	0 0 0 0	0 0 0 0	0 0 0 0	0 0 0 0	0 0 0 0	0 0 0 0	0 0 0 0	0 0 0 0	0 0 0 0	0 0 0 0	0 0 0 0	0 0 0 0	0 0 0 0	0 0 0 0	0 0 0 0	0 0 0 0 0 0 0 0	0 0 0 0	0 0 0 0	0 0 0 0	0 0 0 0	0 0 0 0	0 0 0 0	0 0 0 0	0 0 0 0 0
0	0	0	0	0	0	0	0	0	0	0	0	0	0	0	0	0	0	0	0	0	0	0	0	0	0	0	0	0	0	0	0	0	0	0	0	0	0	0	0	0	0	0	0	0	0	0	0	0	0	0	0	0	0	0	0	0	0	0	0	0	0	0	0	0	0	0	0	0	0	0	0	0	0	0	0	0	0	0	0	0	0	0	0	0	0	0	0	0	0	0	0	0	0	0	0	0	0	0	0	0	0	0	0	0	0	0	0	0	0	0	0	0	0	0	0	0	0	0	0	0	0	0	0	0	0	0	0	0	0	0	0	0
0	0	0	0	0	0	0	0	0	0	0	0	0	0	0	0	0	0	0	0	0	0	0	0	0	0	0	0	0	0	0	0	0	0	0	0	0	0	0	0	0	0	0	0	0	0	0	35	36	37	0	0	0	0	0	0	0	0	0	0	0	0	0	0	0	0	0	0	0	0	0	0	0	0	0	0	0	0	0	0	0	0	0	0	0	0	0	0	0	0	0	0	0	0	0	0	0	0	0	0	0	0	0	0	0	0	0	0	0	0	0	0	0	0	0	0	0	0	0	0	0	0	0	0	0	0	0	0	0	0	0	0	0
0	0	0	0	0	0	0	0	0	0	0	0	0	0	0	0	0	0	0	0	0	0	0	0	0	0	0	0	0	0	0	0	0	0	0	0	0	0	0	0	0	8	0	0	9	0	9	32	33	34	0	0	0	0	0	0	0	0	0	0	0	0	0	0	0	0	0	0	0	0	0	0	0	0	0	0	0	0	0	0	0	0	0	0	0	0	0	0	0	0	0	0	0	0	0	0	0	0	0	0	0	0	0	0	0	0	0	0	0	0	0	0	0	0	0	0	0	0	0	0	0	0	0	0	0	0	0	0	0	0	0	0	0
0	0	0	0	0	0	0	0	0	0	0	0	0	0	0	0	0	0	0	0	0	0	0	0	0	0	0	0	0	0	0	0	0	0	0	0	0	0	0	0	76	77	77	77	77	77	77	77	77	77	76	0	0	0	0	0	0	0	0	0	0	0	0	0	0	0	0	0	0	0	0	0	0	0	0	0	0	0	0	0	0	0	0	0	0	0	0	0	0	0	0	0	0	0	0	0	0	0	0	0	0	0	0	0	0	0	0	0	0	0	0	0	0	0	0	0	0	0	0	0	0	0	0	0	0	0	0	0	0	0	0	0	0
0	0	0	0	0	0	0	0	0	0	0	0	0	0	0	0	0	0	0	0	0	0	0	0	0	0	0	0	0	0	0	0	0	0	0	0	0	0	0	0	73	2	2	2	2	2	2	2	2	2	74	9	0	0	0	0	0	0	0	0	0	0	0	0	0	0	0	0	0	0	0	0	0	0	0	0	0	0	0	0	0	0	0	0	0	0	0	0	0	0	0	0	0	0	0	0	0	0	0	0	0	0	0	0	0	0	0	0	0	0	0	0	0	0	0	0	0	0	0	0	0	0	0	0	0	0	0	0	0	0	0	0	0
0	0	0	0	0	0	0	0	0	0	0	0	0	0	0	0	0	0	0	0	0	0	0	0	0	0	0	0	0	0	0	0	0	0	0	0	0	0	0	77	2	2	2	2	2	7	2	2	2	2	74	77	0	0	0	0	0	0	0	0	0	0	0	0	0	0	0	0	0	0	0	0	0	0	0	0	0	0	0	0	0	0	0	0	0	0	0	0	0	0	0	0	0	0	0	0	0	0	0	0	0	0	0	0	0	0	0	0	0	0	0	0	0	0	0	0	0	0	0	0	0	0	0	0	0	0	0	0	0	0	0	0	0
0	0	9	0	0	0	0	0	8	0	0	9	0	0	0	8	0	0	0	0	0	1	0	0	0	0	0	0	1	0	0	0	0	0	0	0	0	0	0	73	2	2	2	2	2	7	2	2	2	2	2	74	0	0	0	0	0	0	0	0	0	0	0	0	0	0	0	0	0	0	0	0	0	0	0	0	0	0	0	0	0	0	0	0	0	0	0	0	0	0	0	0	0	0	0	0	0	0	0	0	0	0	0	0	0	0	0	0	0	0	0	0	0	0	0	0	0	0	0	0	0	0	0	0	0	0	0	0	0	0	0	0	0
76	77	77	77	77	77	77	77	77	77	77	77	77	77	77	77	77	77	77	77	77	78	79	79	79	79	79	79	76	77	77	77	78	0	0	0	0	0	77	2	2	2	2	2	6	2	2	2	2	2	2	74	77	0	0	0	0	0	0	0	0	0	0	0	0	0	0	0	0	0	0	0	0	0	0	0	0	0	0	0	0	0	0	0	0	0	0	0	0	0	0	0	0	0	0	0	0	0	0	0	0	0	0	0	0	0	0	0	0	0	0	0	0	0	0	0	0	0	0	0	0	0	0	0	0	0	0	0	0	0	0	0	0
2	2	2	2	2	6	2	2	7	2	2	2	2	2	2	2	7	2	2	2	7	74	0	0	0	0	0	0	73	2	6	2	74	0	8	0	0	9	73	2	7	2	2	2	2	2	2	2	2	2	7	2	74	8	0	0	0	0	0	0	0	0	0	0	0	0	0	0	0	0	0	0	0	0	0	0	0	0	0	0	0	0	0	0	0	0	0	0	0	0	0	0	0	0	0	0	0	0	0	0	0	0	0	0	0	0	0	0	0	0	0	0	0	0	0	0	0	0	0	0	0	0	0	0	35	36	37	0	0	0	0	0	0
2	2	2	2	7	2	2	2	6	6	2	2	7	2	2	2	7	2	2	6	2	74	0	0	0	0	0	0	73	2	6	6	74	76	77	77	77	78	73	2	2	2	7	2	2	2	7	7	2	2	2	2	74	76	77	0	0	0	0	0	0	0	0	0	0	0	0	0	0	0	0	0	0	0	0	0	0	0	0	0	0	0	0	0	0	0	0	0	0	0	0	0	0	0	0	0	0	0	0	0	0	0	0	0	0	0	0	0	0	0	0	0	0	0	0	0	0	0	0	0	0	8	31	0	32	33	34	0	0	0	8	9	0
2	2	2	2	2	2	2	2	7	2	7	2	2	2	7	2	2	2	7	2	2	74	10	0	0	0	0	0	73	6	2	2	2	2	7	2	6	2	2	2	2	2	2	2	6	2	2	2	2	2	2	2	2	2	74	31	0	0	0	0	0	0	0	0	0	0	0	0	0	0	0	0	0	0	0	0	0	0	0	0	0	0	0	0	0	0	0	0	31	0	0	0	8	0	0	8	0	0	0	0	0	0	9	9	8	0	0	0	0	0	0	0	0	0	0	0	0	0	0	0	76	77	77	77	77	77	77	77	77	77	77	77	77
7	2	2	7	2	6	6	2	2	2	2	7	2	6	6	2	2	2	2	2	2	74	0	0	0	0	0	11	73	2	2	2	2	2	2	2	7	7	2	2	7	2	2	2	2	2	2	2	2	2	6	6	2	2	74	77	77	78	0	0	0	0	0	0	0	0	9	9	0	0	0	0	0	0	0	0	0	0	0	0	0	0	0	0	0	0	8	76	77	77	77	77	77	77	77	78	0	0	0	0	0	0	76	77	77	78	0	0	0	0	0	0	0	0	0	0	0	0	0	0	73	2	2	2	2	2	2	6	2	2	2	2	2
2	2	2	2	2	2	2	2	2	2	2	2	2	2	2	2	2	2	2	2	2	74	0	0	0	0	0	0	73	2	2	6	2	6	2	6	2	2	2	2	2	2	6	2	2	2	2	2	2	7	2	2	2	2	2	2	2	74	0	0	0	0	0	0	0	76	77	77	77	77	77	77	78	0	0	0	0	0	0	0	0	0	0	8	0	76	77	73	2	2	2	2	2	2	2	74	77	8	0	0	0	0	73	2	2	74	10	0	0	0	0	0	0	0	0	0	0	0	82	80	4	2	2	6	2	2	2	2	2	7	2	2	2
2	2	2	2	6	2	2	2	2	2	2	2	2	2	2	2	2	2	6	2	2	74	0	0	0	0	0	0	73	2	2	2	2	2	2	2	2	2	2	2	2	2	2	2	2	2	7	2	2	2	2	2	7	2	2	2	2	74	77	0	0	0	0	31	77	73	2	2	2	2	2	2	74	77	0	0	0	0	0	0	0	9	0	76	77	73	2	2	2	7	7	2	2	2	7	6	74	77	0	0	0	0	73	2	6	74	0	31	31	0	0	0	0	31	9	0	0	0	0	0	73	7	2	2	7	2	2	2	2	2	2	2	2
2	2	2	2	2	2	2	2	2	2	6	2	2	2	2	2	2	6	2	2	2	74	0	0	0	0	0	0	73	2	2	2	6	2	2	2	2	2	2	2	2	2	2	2	2	2	2	2	2	2	2	7	2	2	2	6	7	7	74	77	9	0	77	77	73	2	2	2	6	2	2	2	2	74	0	8	9	9	9	0	0	76	77	73	2	7	2	2	2	2	2	6	2	2	2	2	2	74	76	77	77	78	73	2	2	74	76	77	77	78	0	0	0	76	77	78	0	0	0	0	73	2	2	2	2	2	2	7	2	2	2	2	2
2	2	2	2	2	2	2	2	2	2	2	2	2	2	2	2	2	2	2	2	2	74	0	0	0	0	0	0	73	2	2	2	2	2	2	2	2	2	7	6	7	2	2	7	7	2	2	2	2	2	2	2	2	2	2	2	2	2	2	74	77	77	73	2	6	7	2	2	2	2	2	7	2	74	76	77	77	77	77	77	77	73	2	2	2	6	2	2	2	2	2	2	2	7	2	2	2	2	2	2	2	2	2	2	2	2	2	2	2	74	0	0	0	73	2	74	0	0	0	0	73	2	2	2	2	2	2	2	2	2	2	2	2
2	2	2	2	2	2	6	2	2	2	2	2	2	2	2	2	2	2	2	2	2	74	0	0	0	0	0	0	73	2	2	2	6	2	2	2	2	2	2	2	2	2	2	2	2	2	6	2	2	2	2	6	2	2	2	7	7	6	7	2	7	2	2	2	2	2	2	7	2	2	7	2	2	7	2	2	2	2	7	2	2	2	2	2	2	2	2	2	2	2	7	2	2	2	2	2	2	2	2	2	2	2	2	2	2	2	2	2	2	74	0	0	0	73	2	74	0	0	0	0	73	2	2	2	2	2	2	2	2	2	2	2	2
2	2	2	2	2	2	2	2	2	2	2	2	2	2	2	2	2	2	2	2	2	74	0	0	0	0	0	0	73	2	2	2	2	2	2	2	2	2	2	2	2	2	2	2	2	2	2	2	2	2	2	2	2	2	2	2	2	2	2	6	2	2	2	2	2	2	2	2	2	2	2	2	2	2	2	2	2	6	2	2	2	2	2	2	2	2	2	2	2	2	2	2	2	2	2	2	2	2	2	2	2	2	2	2	2	2	2	2	2	74	0	0	0	73	2	74	0	0	0	0	73	2	2	2	2	2	2	2	2	2	2	2	2
